#########################
#.....#...........#.....#
#.###.#.#########.#.###.#
#.#...................#.#
#.#.###.###...###.###.#.#
#.#.....#.......#.....#.#
#...###.#.......#.###...#
#.#.....#.......#.....#.#
#.#.###.#########.###.#.#
#.#.........P.........#.#
#.###.#.#########.#.###.#
#.....#...........#.....#
#########################